{
  "legend": {
    "G": "grass",
    "W": "water",
    "C": "collage"
  },
  "rows": [
    "GGGGGGGGGGGGGGGGGGGGGGGGGGGGGG",
    "GGGGGGGGGGGGGGGGGGGGGGGGGGGGGG",
    "GGGGGGGGGGGGGGGGGGGGGGGGGGGGGG",
    "GGGGGGGGGGGGGGGGGGGGGGGGGGGGGG",
    "GGWWWWWWWWWWWWWWGGGGGGGGGGGGGG",
    "GGGGGGGGGGGGGWWWGGGGGGGGGGGGGG",
    "GGGGGGGGGGGGGWWWGGGGGGGGGGGGGG",
    "GGGGGGGGGGGGGGWWWWGGGGGGGGGGGG",
    "GGGGGGGGGGGGGGGWWWGGGGGGGGGGGG",
    "GGGGGGGGGGGGGGWWWWCCCCCCCCCCCC",
    "GGGGGGGGGGGGGGWWWCCCCCCCCCCCCC",
    "GGGGGGGGGGGGGGWWCCCCCCCCCCCCCC",
    "GGGGGGGGGGGGWWGGGCCCCCCCCCCCCC",
    "GGGGGGGGGGGWWGGGGCCCCCCCCCCCCC",
    "GGGGGGGGWWWGGGGGGCCCCCCCCCCCCC",
    "GGGGGGGGGGWWWWWWGGGGGGGGGGGGGG",
    "GGGGGGGGGGGGGGGGWWGGGGGGGGGGGG",
    "GGGGGGGGWWWWWWWWWGGGGGGGGGGGGG",
    "GGGGGGGGWWWGGGGGGGGGGGGGGGGGGG",
    "GGGGGGGWWWWGGGGGGGGGGGGGGGGGGG",
    "GGGGGGWWWWGGGGGGGGGGGGGGGGGGGG",
    "GGGGGWWGGGGGGGGGGGGGGGGGGGGGGG",
    "GGGGWWGGGGGGGGGGGGGGGGGGGGGGGG",
    "GGGWWGGGGGGGGGGGGGGGGGGGGGGGGG"
  ]
}
